IMP|Drought

M|/\[ ](..)`_____,{==}(...
M|`,[ ]`__,0DDDDDDDDD1`___
M|-\[  DDDD           D1{=
M|.)[                  ]??
M|_,[                  ]/-
M|??[                  ]`_
M|-\[                  ]{=
M|.)[                  ]/\
M|_,[                  ]()
M|/----\[       ]/--\[ ]`,
M|(....)[       ](..)[ ]/-
M|(....)/---\{==}`__,[ ](.
M|(....)(...)/------\[ ](.
M|`____,(...)(......)[ ]`_

ENM|11|3|GearEnemy

RPT|3|0|18|14|Drought