IMP|Drought

M|()[`___,{=}`____,`___,(.
M|()[DDDDDDDDDDDDDDDDDD1(.
M|()[                  ](.
M|`,[                  ](.
M|/\[                  ](.
M|()[                  ]`_
M|()[ ]{===}[          ]/-
M|`,[  DDDDD           ](.
M|/\[         ]{===}[  ](.
M|()[          DDDDD   ](.
M|()[                  ](.
M|`,{==}/--\/---\/----\](.
M|/--\/\(..)`___,(....)](.
M|`__,`,`__,?{==}`____,](.

LDR|21|0|3
LDR|2|10|4

ENM|15|6|CrawlEnemy
ENM|7|8|CrawlEnemy

RPT|3|3|19|9|Drought