IMP|Drought

M|....)(.)[      ](.......
M|____,(.)[      ](.......
M|----\`_,[      ]`_______
M|....)0DD        DD1/---\
M|....)[b          B](...)
M|....)[bbbbbbbbbbbb]`___,
M|____,[b           ]/-\/-
M|/--\#[bbbbbbbbbbbb](.)(.
M|(..)![           b](.)`_
M|(..)@[bbbbbbbbbbbb]`_,?{
M|`__,?[b           ]/----
M|----\[bbbbbbbbbbbb]`____
M|....)[            ]/--\?
M|____,[            ](..)/

RPT|3|0|20|14|Drought