IMP|Drought

M|--\(..)?@/\`_,?(){}`,{=}
M|__,`__,{}`,?{=}`,?{}{}{}
M|}                      {
M|\                      /
M|)                      `
M|,                      ?
M|\                      /
M|,                      `
M|1                      ?
M|]                      /
M|]                      (
M|]                      `
M|/\{}/\{}{}?/-\?{}/\{=}/-
M|`,/\`,{=}/\(.){=}`,/-\(.

DOR|0|2|Boss

BOS|21|2|DroughtBot