IMP|Drought

M|______,?{=====}?{=}?{}/\
M| DDDDDDDDDDDDDDDDDDDD1`,
M|                     ]  
M|                     ]  
M|                      DD
M|====}[       ]{=}[      
M|}/--\[        DDD       
M|#(..)[                  
M|@(..)[            ]/-\  
M|}(..)[            ](.)  
M|-\{=}[            ](.)/\
M|.)/-\[       ]{===}(.)()
M|.)(.)/----\/------\`_,`,
M|.)`_,`____,(......){===}

DOR|0|9|Gold
DOR|22|4|Bolt

RPT|1|2|23|10|Drought