IMP|Flood

M|........................
M|.)/DDDDDDDDDDDDDDDDDD\(.
M|.)[                  ](.
M|.)[                  ](.
M|.)[                  ]  
M|.)[                  ]  
M|.)[                   DD
M|.)[                     
M|.)[                     
M|.)[                     
M|.)[(.....)    (......)  
M|.)[(.....)    (......)  
M|.)[(....................
M|.)[(....................

LDR|2|0|4

DOR|22|2|Bolt

RPT|0|0|24|14|FloodInterior