IMP|Flood

M|...x.o...)    (...o.....
M|.)     (x)           m(.
M|.)     (.)            (.
M|.)     (........)     (.
M|t)                    (.
M|l)                    (t
M|o)                    (l
M|                      (l
M|                      (o
M|                      (.
M|                      (.
M|.....)m              m(.
M|..t..)---------------->.
M|..l......t....l..l..x...

ROM||||||true

SPP|16^4|19^7

WTR|15

DOR|0|3|Cyan
LDR|10|11|3