IMP|Flood

M|....................)](.
M|.)/DDDDDDDDDDDDDDDDDD](.
M|.)[                  ](.
M|.)[    (................
M|.)[    DDDDDDDDDDDDDD\(.
M|.)[                  ](.
M|.)[ %                ](.
M|.)[ D                ](.
M|.)[   %              ](.
M|.)[   D   %          ](.
M|.)[       D   %      ](.
M|.)[           D  ](.)](.
M|.)[              ](.)](.
M|....................)](.

LDR|21|0|3
LDR|21|11|3

SPP|14^3~6^5|10^4~4^7

RPT|0|0|24|14|FloodInterior