IMP|Flood

M|.........)    (.........
M|.)     (.)    (.)     (.
M|.)     (.)    (.)     (.
M|.)            (.)     (.
M|.)            (.)     (.
M|.)            (.)     (.
M|.)     (.)    (.)     (.
M|.)     (.)    (.)       
M|.)     (........)       
M|.)                      
M|.)                      
M|........................
M|........................
M|........................

WTR|15

DOR|23|3|Cyan

ENM|20|3|SwimEnemy