IMP|Flood

M|...............)      (.
M|...........)          (.
M|........)             (.
M|......)               (.
M|.....)                (.
M|....)                 (.
M|...)                  (.
M|...)                  (.
M|..)                   (.
M|..)                   (.
M|..)          mmm     m(.
M|.)          m(.)m     (.
M|.)m        m(..)     m(.
M|.)        m(...)m     (.

WTR|15