IMP|Flood

M|.)      (......)      (.
M|.)         m(..)      (.
M|.)          (..)      (.
M|.)    ()    (..)      (.
M|.)    ()    (..)      (.
M|       )    (..)      (.
M|       )    (..)      (.
M|       )    (..)        
M|       )    (..)        
M|       )                
M|       )                
M|       )        (.......
M|       )        (.......
M|       .................

WTR|15

DOR|23|3|Cyan

DSK|2|9

RPT|0|0|7|9|FloodForeground|||2|1