IMP|Flood

M|........................
M|.)/DDDDDDDDDDDDDDDDDD\(.
M|.)[                  ](.
M|.)[                  ](.
M|.)[                  ](.
M|.)[                  ](.
M|.)                    (.
M|       (.)    (.)   m (.
M|       (.)    (.)    m(.
M|      m(.)    (.) m   (.
M|     mm(.)    (.)m m m(.
M|.........)    (.........
M|.........)    (.........
M|.........)    (.........

WTR|8

DOR|0|3|Cyan

RPT|2|8|20|5|FloodInterior