IMP|Flood

M|........................
M|DDDDDDDDDDDDDD(.........
M|              (.........
M|              (.........
M|              (.........
M|.........)    (.........
M|...)DDDDDD    (.........
M|...)          (.........
M|...)    (....)DDDDDDDDDD
M|...)    DDDDDD          
M|...)                    
M|...)                    
M|........................
M|........................

DOR|0|9|Boss
DOR|23|2|Boss

RPT|0|0|24|14|FloodInterior