IMP|Flood

M|....................)](.
M|.)/DDDDDDDDDDDDDDDDDD](.
M|.)[                  ](.
M|.)[                  ](.
M|.)[                  ](.
M|.)[                D ](.
M|.)                    (.
M|                  m   (.
M|         m            (.
M|     m               m(.
M|               m      (.
M|........................
M|........................
M|........................

WTR|8

DOR|0|3|Cyan
LDR|21|11|3

SPP|16^5|19^9

RPT|0|8|24|5|FloodInterior