IMP|Flood

M|.)[(....................
M|.)[DDDDDDDDDDDDDDDDDD\(.
M|.)[                  ](.
M|.)[                  ](.
M|.)[                  ](.
M|.)[            ()    ](.
M|.)[            ()    ](.
M|.)[            ()     D 
M|.)[            (..)     
M|.)[            (..)     
M|.)[            (..)     
M|.)[            (....)](.
M|.)[            (....)](.
M|....................)](.

LDR|21|0|3
LDR|14|1|8
LDR|2|11|3

DOR|23|3|Cyan

RPT|0|0|24|14|FloodInterior