IMP|Flood

M|...o....l)    (..o..o...
M|.)     (o)    (.)     (.
M|.)     (.)    (x)     (.
M|.)            (.)     (.
M|t)            (.)     (x
M|l)            (.)     (.
M|l)     (.)    (.)     (.
M|o)     (.)    (.)       
M|.)     (....x...)       
M|.)                      
M|.)                      
M|..........t.............
M|....t..x..l.......x..t..
M|.x..l.....l....t.....l..

WTR|15

DOR|23|3|Cyan

ENM|20|3|SwimEnemy