IMP|Flood

M|)()pi(.x...)(..x..)pi()(
M|)()PI(.....)(.....)PI()(
M|)/DDDDDD3cbbbbn4DDDDDD\(
M|)[,,,,,,C1BBBB2N,,,,,,](
M|)[,,,]            [,,,](
M|)[,,,]            [,,,](
M|)[,,,]            [,,,](
M|)[,,,]            [,,,](
M|\[,,,]            [,,,](
M|][,,,]            [,,,](
M|][,,,,DDDDDDDDDDDD,,,,](
M|][,,,,,,,,,,,,,,,,,,,,](
M|)(.........)(.........)(
M|)(.......x.)(..x...x..)(

WTR|2

BOS|21|2|FloodBot

DOR|0|2|Boss