IMP|Cyclone

M|________________________
M|d)23232323232323232323(f
M|.)                    (C
M|M)  {==============}  (.
M|f)  323232(.p)323232  (M
M|.)        (dC)        (L
M|_,{==}    (P.)    {==}`_
M| 32323    (.d)    23232 
M|          (p.)          
M|        /------\        
M|        (dLdMf.)        
M|------------------------
M|d/--------------------\.
M|.(.CfsG.L..s.d.g.s.f..)P

DOR|0|3|Cyan
DOR|23|3|Cyan

ENM|12|12|ShieldedEnemy

RPT|1||||Cyclone