IMP|Hail

M|(..,.....,...){}{}{}{}{}
M|(,......,....)i{ =======
M|I'BBBBBBBBBBBB{ { { { { 
M|>[ d     d    i{ { { { {
M|I[          d { { { { { 
M|>[   d        i{ { { { {
M|---*---*-\    { { { { { 
M|..,......)d   i{ { { { {
M|....,....)    BBBBBBBB`I
M|.......,.)   d        ]<
M|.,.......)      d     ]I
M|.....,...) d       d  ]<
M|...,.....)==============
M|......,..)i{}{}{}{}{}{}{

DOR|0|8|Boss
DOR|23|2|Boss

RPT|0|2|22|9|HailBrickDark