IMP|Hail

M|{}{}{}{}{}{}{}{}{}{}{}{}
M|========================
M|i                      i
M|}                      {
M|i                      i
M|}                      {
M|i                      i
M|}                      {
M|I                      i
M|>                      {
M|I                      i
M|>                      {
M|========================
M|}{}{}{}{}{}{}{}{}{}{}{}{

BOS|21|2|HailBot

DOR|0|2|Boss