IMP|Hail

M|...,.....,...){}{}{}{}{}
M|.,......,....)i{ =======
M|BBBBBBBBBBBBBB{ { { { { 
M|              i{ { { { {
M|              { { { { { 
M|              i{ { { { {
M|---*---*-\    { { { { { 
M|..,......)    i{ { { { {
M|....,....)    BBBBBBBB`I
M|.......,.)            ]<
M|.,.......)            ]I
M|.....,...)            ]<
M|...,.....)==============
M|......,..)i{}{}{}{}{}{}{

DOR|0|8|Boss
DOR|23|2|Boss

RPT|0|2|22|9|HailBrickDark